methodlol|methodlol() : void|java
|methodlol() : void|java
sout|sout|snippets
pub|public_static_method|snippets
sys|systems|around
oper|operating|around
N|N_MINUS_TWO : long|java
nextLon|nextLong() : long|java
Sca|Scanner;|java
java.uti|java.util|java
n_|N_MINUS_ONE : long|java
psvm|pclpsvm|snippets
id|id_rsa|around
kal|kali|file
P|ProxyJump|around
|ssh-key.pem|file
|bastion|file
Iden|IdentityFile|around
lol|localhost|around
Pre|PreferredAuthentications|around
|kali-priv.pem|file
bas|bastionKali|file
isA|isAnagram|around
Prox|ProxyJump|around
keys|keys|file
is|isAnagram|around
psv|pclpsvm|snippets
loca|localhost|around
kali|kaliLocal|around
twe|tweepy|python-import
i|id_rsa|file
Ident|IdentityFile|around
|id_ed25519|file
git|github|around
chrig|chrigLocal|around
root|root|around
chrig|chrig|around
chrig|chrigFromBastion|around
or|lorem|snippets
Identi|IdentityFile|around
dog|doggo|around
textRe|textReversed|around
pcl|pclpsvm|snippets
UseKey|UseKeychain|around
AddKeys|AddKeysToAgent|around
local|localhost|around
repo|repository|around
braches|branches|around
master|master|around
reposi|repository|around
dig|digitPlace|pyright
digita|digitPlace|pyright
digit|digitPlace|pyright
append|append|pyright
pas|pass|pyright
digitPl|digitPlace|pyright
false|False|pyright
is|isPalindrome|pyright
def|def|snippets
sout|solution|snippets
sl|silent|around
eni|environment|around
df|definition|around
math|math|pyright
math|math|python-import
ya|yapf|around
w|wrap|around
screen|screen|around
if|if|snippets
|Applications|file
zsh|zsh|around